#WW#WWWWWW#WWW#WWW##
W  W  & & W   W   W#
W &W   W WW+++&  & W
W  &  & WW++++W &  W
W WW   WW++++W   & W
W &    W++++WW &   W
W &WW  W+++W       W
W   &&&WW&WW  WWW W#
W W W  W   W  W    W
W & W  &  WW       W
W    W    W*       W
#WWWW#WWWW#WWWWWWWW#