#WW######WWW###WWWW#
W  WWWWWW   WWW   +W
W  W    W$   $  +++W
W $W *     WWWWW+++W
W  W  WWW$  W  WWWW#
W $WW W#W $ W $ +W##
W   W W#W$     +W###
W$ $W W#W $ W +W####
W     WWW$   +W#####
W+$W        WW######
W +W        W#######
#WW#WWWWWWWWW#######