####################
#######WWWWW########
####WWW     W#######
###W   +WWW W#######
###W W W    W#######
###W W & &W+ W######
###W W + & W W######
###W +W& & W W######
####W    W W WW#####
####W WWW+ *   W####
####W     WW   W####
#####WWWWW##WWW#####