####################
######WWWWW#########
#####W   D W########
#####W B W WWW######
######W BWBTTTW#####
#####W   B TTTW#####
#####W WW B W#######
#####W    B W#######
######WW    W#######
########WWWW########
####################
####################