####################
#######WWWWW########
####WWW     W#######
###W   TWWW W#######
###W W W    W#######
###W W B BWT W######
###W W T B W W######
###W TWB B W W######
####W    W W WW#####
####W WWWT D   W####
####W     WW   W####
#####WWWWW##WWW#####