#$$$$$#$##$#$$$$####
###$###$##$#$#######
###$###$$$$#$$$#####
###$###$##$#$#######
###$###$##$#$$$$####
####################
###$$$$#$##$#$$$##$#
###$####$$#$#$##$#$#
###$$$##$#$$#$##$#$#
###$####$##$#$##$#W#
###$$$$#$##$#$$$#W*W
##################W#