#WWWWWWWWWWWWWWWWWW#
#W                W#
#W         W      W#
#W   WWWWWWW      W#
#W   TB    W B    W#
#W   W  T DW B    W#
#W   WW    W B    W#
#W    W    W      W#
#W    W    W   WW W#
#W    WWWBWW   W TW#
#W              TTW#
#WWWWWWWWWWWWWWWWWW#