#+++++#+##+#++++####
###+###+##+#+#######
###+###++++#+++#####
###+###+##+#+#######
###+###+##+#++++####
####################
###++++#+##+#+++##&#
###+####++#+#+##+#&#
###+++##+#++#+##+#&#
###+####+##+#+##+#W#
###++++#+##+#+++#W*W
##################W#