#WWW#WW#W#W##WW#####
W   W  W W WW  W####
W W W BD    B  WW###
W W    WWWWWW B  WW#
W   W  WTTTTW  BB  W
#WBWWBWWTTTTW      W
W      WTTTTWWBWWBW#
W  BB  WTTTTW      W
W B  B  W  W  WWW  W
#WWWW  B        B  W
####W W    W  W   W#
#####W#WWWW#WW#WWW##