####################
#######WWWWWW#######
######W      W######
######W WWWWBW######
#####W    W  W######
#####W B  B DW######
#####W B  WTTW######
#####W    WTTW######
#####W    WWW#######
#####W    W#########
######WWWW##########
####################