####################
#######WWW##########
######WD  W#########
######W BBW##W######
######W B W#WTW#####
#######WW WWWTW#####
########W    TW#####
#######W   W  W#####
#######W   WWW######
########WWW#########
####################
####################

