#WWWWWWWWWWWWWWWWWW#
W+W                W
W+W              W W
W W           &  W W
W W  &             W
W W      *       W W
W W              W W
W W           &  W W
W W  &           W W
W                W+W
W                W+W
#WWWWWWWWWWWWWWWWWW#