####################
####################
##########W#########
#########W+W########
#########W WWW######
########WW& &+W#####
#######W+ &*WW######
########WWW&W#######
##########W+W#######
###########W########
####################
####################