#WW#WWWWWW#WWW#WWW##
W  W  B B W   W   W#
W BW   W WWTTTB  B W
W  B  B WWTTTTW B  W
W WW   WWTTTTW   B W
W B    WTTTTWW B   W
W BWW  WTTTW       W
W   BBBWWBWW  WWW W#
W W W  W   W  W    W
W B W  B  WW       W
W    W    WD       W
#WWWW#WWWW#WWWWWWWW#