####################
####################
#######WWWWW########
######W     WW######
######W$WWW   W#####
#####W*  $  $ W#####
#####W ++W $ W######
######W++W   W######
#######WW#WWW#######
####################
####################
####################

