#WWWW#WWWWWWW#WW#WW#
W++++W       W  W  W
W++++W W &  &      W
W++++ WW  &W W &W& W
W+++W   &   &W  &  W
W++WWWW  W &   &&  W
W      WW#W WWWW WW#
W        W   W     W
W WW   W   & W & & W
W WW    & WW &  &  W
W     *W     W   W W
#WWWWWW#WWWWW#WWW#W#