######W#WWWWWW######
#####W+W      WWW###
####W++W &  & W  W##
###W+++W WW & W  W##
###W+++++  W&&   W##
####W++++&    W& W##
####WWW WWWWWWW  W##
###W   &        W###
###W  & W  &W & W###
###W &WWW & W && W##
###W   *W  WW    W##
####WWWW#WW##WWWW###