######W#WWWWWW######
#####WTW      WWW###
####WTTW B  B W  W##
###WTTTW WW B W  W##
###WTTTTT  WBB   W##
####WTTTTB    WB W##
####WWW WWWWWWW  W##
###W   B        W###
###W  B W  BW B W###
###W BWWW B W BB W##
###W   DW  WW    W##
####WWWW#WW##WWWW###