#WWWWWWWWWWWWWWWWWW#
WTW                W
WTW              W W
W W           B  W W
W W  B             W
W W      D       W W
W W              W W
W W           B  W W
W W  B           W W
W                WTW
W                WTW
#WWWWWWWWWWWWWWWWWW#