####################
#######WWW##########
######W*  W#########
######W $$W##W######
######W $ W#W+W#####
#######WW WWW+W#####
########W    +W#####
#######W   W  W#####
#######W   WWW######
########WWW#########
####################
####################

