#WW######WWW###WWWW#
W  WWWWWW   WWW   TW
W  W    WB   B  TTTW
W BW D     WWWWWTTTW
W  W  WWWB  W  WWWW#
W BWW W#W B W B TW##
W   W W#WB     TW###
WB BW W#W B W TW####
W     WWWB   TW#####
WTBW        WW######
W TW        W#######
#WW#WWWWWWWWW#######