#WWWWWW###WWW#WW#WW#
W*     WWW   W  W  W
W W W  W  &  &     W
#W#WW     W & &W&W W
W+W++W    WW& &    W
W+++++    &   W   W#
W+++++    WWW&WW&WW#
W+W++W    &    W   W
#W#WW     W  W&  & W
####W  W  &    & & W
####W  W  W  W  W  W
#####WW#WW#WW#WW#WW#