####################
####################
##########W#########
#########WTW########
#########W WWW######
########WWB BTW#####
#######WT BDWW######
########WWWBW#######
##########WTW#######
###########W########
####################
####################