#WWWW#WWWWWWW#WW#WW#
WTTTTW       W  W  W
WTTTTW W B  B      W
WTTTT WW  BW W BWB W
WTTTW       BW  B  W
WTTWWWW  W B   BB  W
W      WW#W WWWW WW#
W        W   W     W
W WW   W   B W B B W
W WW    B WW B  B  W
W     DW     W   W W
#WWWWWW#WWWWW#WWW#W#