#WWWWWWWWWWWWWWWWWW#
#W                W#
#W         W      W#
#W   WWWWWWW      W#
#W   +$    W $    W#
#W   W  + *W $    W#
#W   WW    W $    W#
#W    W    W      W#
#W    W    W   WW W#
#W    WWW$WW   W +W#
#W              ++W#
#WWWWWWWWWWWWWWWWWW#