####################
###W#W#W#W#W#W#W#W##
##WTWTWTWTWTWTWTWTW#
#WTB B B B B      W#
##W W W W W W W W W#
#WTB     B       BW#
##W W W W W W W W W#
#WT        B   B  W#
##W W W W W W W W W#
#WT          B   DW#
##WWWWWWWWWWWWWWWW##
####################