####################
###W#W#W#W#W#W#W#W##
##W+W+W+W+W+W+W+W+W#
#W+& & & & &      W#
##W W W W W W W W W#
#W+&     &       &W#
##W W W W W W W W W#
#W+        &   &  W#
##W W W W W W W W W#
#W+          &   *W#
##WWWWWWWWWWWWWWWW##
####################