#WWWWWW###WWW#WW#WW#
WD     WWW   W  W  W
W W W  W  B  B     W
#W#WW     W B BWBW W
WTWTTW    WWB B    W
WTTTTT    B   W   W#
WTTTTT    WWWBWWBWW#
WTWTTW    B    W   W
#W#WW     W  WB  B W
####W  W  B    B B W
####W  W  W  W  W  W
#####WW#WW#WW#WW#WW#