####################
####################
#######WWWWW########
######W     WW######
######WBWWW   W#####
#####WD  B  B W#####
#####W TTW B W######
######WTTW   W######
#######WW#WWW#######
####################
####################
####################

