#WWW#WW#W#W##WW#####
W   W  W W WW  W####
W W W &*    &  WW###
W W    WWWWWW &  WW#
W   W  W++++W  &&  W
#W&WW&WW++++W      W
W      W++++WW&WW&W#
W  &&  W++++W      W
W &  &  W  W  WWW  W
#WWWW  &   &    &  W
####W W    W  W   W#
#####W#WWWW#WW#WWW##