####################
#######WWWWWW#######
######W      W######
######W WWWW$W######
#####W    W  W######
#####W $  $ *W######
#####W $  W++W######
#####W    W++W######
#####W    WWW#######
#####W    W#########
######WWWW##########
####################